111111111111111111111111111111111111111111111111
111111111111111111111111111111111111111111111111
111111111111111111111111111111111111111111111111
111111111111111111111111111111111111111111111111
111111111111111111111111111111111111111111111111
111111111111111111111111111111111111111111111111
111111100000000000000000000000000000000000000000
111111100000000000000000000000000000000000000000
111111100000000000000000000000000000000000000000
111111100000000000000000000000000000000000000000
111111100000000000000000000000000000000000000000
111111100000000000000000000000000000000000000000
111111100000000000000000000000000000000000000000
111111100000000000000000000000000000000000000000
111111100000000000000000000000000000000000000000
111111100000000000000000000000000000000000000000
111111100000000000000000000000000000000000000000
111111100000000000000000000000000000000000000000
111111100000000000000000000000000000000000000000
111111100000000000000000000000000000000000000000
111111100000000000000000000000000000000000000000
111111100000000000000000000000000000000000000000
111111100000000000000000000000000000000000000000
111111100000000000000000000000000000000000000000
111111100000000000000000000000000000000000000000
111111100000000000000000000000000000000000000000
111111100000000000000000000000000000000000000000
111111100000000000000000000000000000000001111111
111111100000000000000000000000000000000001111111
111111100000011110000000011110000000000001111111
111111100000000000000000000000000001111111111111
111111100000000000000000000000000001111111111111
111111111111111111111111111111111111111111111111
111111111111111111111111111111111111111111111111
111111111111111111111111111111111111111111111111
111111111111111111111111111111111111111111111111
111111111111111111111111111111111111111111111111
111111111111111111111111111111111111111111111111
111111111111111111111111111111111111111111111111
111111111111111111111111111111111111111111111111
