// the file must contain at least 27 rows and except for the last row cannot contain any empty lines
// 0 = air
// 1 = dirt (edge-grass-coverage done separately)
// 2 = spawn
111111111111111111111111111111111111111111111111
111111111111111111111111111111111111111111111111
111100000000000000000000000000000000000000000000
111100000000000000000000000000000000000000000000
111100000000000000000000000000000000000000000000
111100000000000000000000000000000000000000000000
111100000000000000000000000000000000000000000000
111100000000000000000000000000000000000000000000
111100000000000000000000000000000000000000000000
111100000000000000000000000000000000000000000000
111100000000000000000000000000000000000000000000
111100000000000000000000000000000000000000000000
111100000000000000000000000000000000000000000000
111100000000000000000000000000000000000000000000
111100000000000000000000000000000000000000000000
111100000000000000000000000000000000000000000000
111100000000000000000000000000000000000000000000
111100000000000000000000000000000000000000000000
111100000000000000000000000000000000000000000000
111100000000000000000000000000000000000000000000
111100000000000000000000000000000000000000000000
111100000000000000000000000000000000000000000000
111100000000011110000000011110000000000000000000
111100000000011110000000011110000000000000000000
111100000000000000000000000000000000000001111111
111100000000000000000000000000000000000001111111
111100000000000000000000000000000000000001111111
111100000000000000000000000000000001111111111111
111100020000000000000000000000000001111111111111
111111111111111111111111111111111111111111111111
111111111111111111111111111111111111111111111111
